##########
#        #
#        #
# XXXXXXE#
# X      #
# X      #
# X      #
# S      #
#        #
##########
